WE ./textures/wall_3.xpm
NO ./textures/wall_1.xpm
SO ./textures/wall_2.xpm
EA ./textures/wall_4.xpm

F 255,255,200
C 225,255,255

        1111111111111111111111111
        1000000000110000000000001
        1011000001110000000000001
        1001000000000000000000001
111111111011000001110000000000001
100000000011000001110111111111111
11110111111111011100000010001
11110111111111011101010010001
11000111110101011100000010001
100000N0000000011000000100001
10000000000000001101010010001
11111000110101011111011110001
1111010111110101 101111010001
11111111 1 11111 111111111111